1
13
15
###############
#p     s    1*#
# # # # # # # #
#  x          #
# # # # # # # #
#             #
# # # # # # # #
#             #
# # # # # # # #
#             #
# # # # # # # #
#             #
###############