1
13
15
[WWWWWWWWWWWWW]
Lp     s    2*R
L # # # # # # R
L  x          R
L # # # # # # R
L             R
L # # # # # #*R
L       *     R
L # # # # # # R
L             R
L # # # # # # R
L****         R
{DDDDDDDDDDDDD}