1
13
15
[WWWWWWWWWWWWW]
Lp    **  1  *R
L # #*# #*#*# R
L  s    1*  1*R
L # # # #*# # R
L     ***     R
L #*# #*#*# #*R
L***  f     * R
L*# # #*#*#*#*R
L *x       *  R
L #*# # # #*# R
L             R
{DDDDDDDDDDDDD}