1
13
15
[WWWWWWWWWWWWW]
Lpw   **  1  *R
L # #*# #*#*# R
L  s    1*  1*R
L # # # #*# # R
L     ***     R
L #*# #*#*# #*R
Ll**  f     * R
L*# # #*#*#*#*R
L *x       *  R
L #*# # # #*# R
L             R
{DDDDDDDDDDDDD}