0
13
15
[WWWWWWWWWWWWW]
Lp     s     *R
L # # # # # # R
L             R
L # # # # # # R
L             R
L # # # # # #*R
L       *     R
L # # # # # # R
L             R
L # # # # # # R
L****        qR
{DDDDDDDDDDDDD}