2
29
15
[WWWWWWWWWWWWW]
Lp **  ****  1R
L # # #*# # #*R
L b *3    *** R
L #*#*# # #w# R
L *    1   x *R
L #*# # # # # R
L* ** *    * 4R
L # # # #*# # R
L*4* ***  * 1*R
L #*# #*# # # R
L* *  * 1   * R
L # #*#*#*# # R
L   1 *  3    R
L # # #f# # # R
L  ***   3    R
L*# # #*# #*# R
L*    1  *    R
L*#*# # # # #2R
L* *  3       R
L*# #*#*# #*#*R
L** 1     * 3 R
L #*# #s# #*#*R
L   1  **   1 R
L #*#*# #*#*# R
L  **   *1  2 R
L3# # #*#*#*#*R
L   **     4  R
{DDDDDDDDDDDDD}