3
13
31
[WWWWWWWWWWWWWWWWWWWWWWWWWWWWW]
Lp *    *1w  1 *  *  * * *    R
L # # #*# # #*#*# # # #*#*#*# R
L b *  3  *s*  *  1   * 3 * * R
L # # # # #*# # #*#*# # # # #*R
L*   * 1   * **  *  *  1      R
L # #*# #*# # # # #*# #*# #2# R
L*  * f  3 *  * 3    *1       R
L # # # #*# #*#x#*#*# #*# # # R
L*    **  *     2 *   *  *   *R
L #*# # # #*#*#*#*# # # #*# # R
L        *4      * *   3     *R
{DDDDDDDDDDDDDDDDDDDDDDDDDDDDD}