2
13
31
[WWWWWWWWWWWWWWWWWWWWWWWWWWWWW]
Lp      * *  1 * 2 *  * * *   R
L # # #*# # #*#*# # # #*#*#*# R
L b *     ***  *  1   * 2 * * R
L # # # # #*# # #*#*# # # # #*R
Lf         x **  *  *         R
L # # # # # # # # #*# #*# # # R
L*  *      *  *      *1       R
L # # # #*# # # #*#*# # # # # R
L*    **  *       *           R
L #*# # # # # # #*# # # # # # R
L           *   *  *          R
{DDDDDDDDDDDDDDDDDDDDDDDDDDDDD}