1
13
15
###############
#p     s     *#
# # # # # # # #
#  x          #
# # # # # # # #
#             #
# # # # # # #*#
#       *     #
# # # # # # # #
#             #
# # # # # # # #
#****        2#
###############